Unemployment rate,% dropout,,Dropout,Enrolled,Graduate,Grand Total
16.2,38.40%,,139,46,177,362
7.6,35.38%,,202,119,250,571
15.5,35.01%,,139,69,189,397
10.8,34.67%,,182,90,253,525
12.7,33.65%,,141,63,215,419
9.4,32.65%,,174,109,250,533
13.9,30.26%,,118,64,208,390
11.1,28.26%,,117,67,230,414
8.9,27.72%,,102,77,189,368
12.4,24.04%,,107,90,248,445